170
12
73 0 0 0 0 0 0 0 0 0 0 0 0 0 0 0 0 0 0 0 0 0 0 0 0 0 0 0 0 0 0 0 0 0 0 0 0 0 0 0 0 0 0 0 0 0 0 0 0 0 0 0 0 0 0 0 0 0 0 0 0 0 0 0 0 0 0 0 0 0 0 0 0 0 0 0 0 0 0 0 0 0 0 0 0 0 0 0 0 0 0 0 0 0 0 0 0 0 0 0 0 0 0 0 0 0 0 0 0 0 0 0 0 0 0 0 0 0 0 0 0 0 0 0 0 0 0 0 0 0 72 73 0 0 0 0 0 0 0 0 0 0 0 0 0 0 0 0 0 0 0 0 0 0 0 0 0 0 0 0 0 0 63 0 0 0 0 0 0 0 
73 0 0 0 0 0 0 0 0 0 0 0 0 0 0 0 0 0 0 0 0 0 0 0 0 0 0 0 0 0 0 0 0 0 0 0 0 0 0 0 0 0 0 0 0 0 0 0 0 0 0 0 0 0 0 0 0 0 0 0 0 0 0 0 0 0 0 0 0 0 0 0 0 0 0 10 11 12 0 0 0 0 0 0 0 0 0 0 0 0 0 0 0 0 0 0 0 0 0 0 0 0 0 0 0 0 0 0 0 0 0 0 0 0 0 0 0 0 0 0 0 0 0 0 0 0 0 0 0 0 72 73 0 0 0 0 0 0 0 0 0 0 0 35 36 0 0 0 0 0 0 0 0 0 0 0 0 0 0 0 0 0 63 0 0 0 0 0 0 0 
73 0 0 0 0 0 0 0 0 0 0 0 0 0 0 0 0 0 0 0 0 0 0 0 0 0 0 0 0 0 0 0 0 0 0 0 0 0 0 0 0 0 0 0 0 0 0 0 0 0 0 0 0 0 0 0 0 0 0 0 0 0 0 0 0 0 0 0 0 0 0 0 0 0 0 13 14 15 17 0 0 0 0 0 0 0 0 0 0 0 0 0 0 0 0 0 0 0 0 0 0 0 0 0 0 0 0 0 0 0 0 0 0 0 0 0 0 0 0 0 0 0 0 0 0 0 0 0 0 0 72 73 0 0 0 0 0 0 0 0 0 0 0 38 38 0 0 0 0 0 0 0 0 0 0 0 0 0 0 0 0 0 63 0 0 0 0 0 0 0 
73 0 0 0 0 0 0 0 0 0 0 0 0 0 0 0 0 0 0 0 0 0 0 0 0 0 0 0 0 0 0 0 0 0 0 0 0 0 0 0 0 0 0 0 0 0 0 0 0 0 0 0 0 0 0 0 0 0 0 0 0 0 0 0 0 64 0 0 0 0 0 0 0 0 70 65 65 65 65 0 0 0 0 0 0 0 0 0 0 0 0 19 20 20 20 20 20 20 20 20 21 0 0 0 0 0 0 0 0 0 0 0 0 0 0 0 0 0 0 0 0 0 0 0 0 0 0 0 0 0 72 73 0 0 0 0 0 0 0 0 63 0 0 70 71 0 0 0 0 0 0 0 0 0 0 0 0 0 0 0 0 0 63 0 0 0 0 8 4 8 
73 0 0 0 0 0 0 0 0 0 0 0 0 0 0 0 0 0 0 0 0 0 0 0 0 0 0 0 0 0 0 0 0 0 0 0 0 0 58 59 60 0 0 0 0 0 0 0 0 0 0 0 0 0 0 0 0 0 0 0 0 0 0 0 0 64 64 0 0 0 0 0 0 0 72 78 78 78 78 0 0 0 0 0 0 0 0 0 0 0 0 22 23 23 23 23 23 23 46 46 24 0 0 0 0 0 0 10 11 12 0 0 0 0 0 0 0 0 0 0 0 0 0 0 0 0 0 0 0 0 72 73 0 16 0 17 0 0 0 0 0 0 0 72 68 71 0 0 0 0 0 0 0 0 0 0 0 0 0 0 0 0 63 0 0 16 0 9 3 0 
73 0 0 0 0 0 0 0 0 0 0 0 0 0 0 0 0 0 0 0 0 0 0 0 0 0 0 0 0 18 17 0 0 0 0 0 0 0 61 57 61 0 0 0 0 0 0 0 0 0 0 0 0 0 0 0 0 0 0 0 0 0 0 0 0 0 0 0 0 0 0 0 64 0 72 78 65 78 78 0 25 26 27 0 0 0 0 0 0 0 0 22 23 23 23 23 23 23 23 23 24 0 0 0 0 16 0 13 14 15 0 0 0 0 0 0 0 0 0 0 0 0 0 0 0 0 0 0 0 0 72 68 65 65 65 65 71 0 0 0 0 0 0 72 78 68 71 0 0 0 0 0 0 0 0 0 0 0 0 0 0 0 0 0 0 70 65 65 65 65 
73 0 0 0 0 0 0 0 0 0 0 0 0 0 0 0 0 0 0 0 0 0 0 0 0 0 0 0 0 70 65 65 65 65 65 71 0 0 57 57 57 0 0 0 0 0 0 0 0 16 0 0 0 0 0 0 0 0 0 0 0 0 0 0 0 64 0 64 0 0 0 0 0 0 72 65 78 78 78 0 0 0 0 0 0 0 0 0 0 0 0 22 23 23 23 23 23 23 23 23 24 0 0 0 48 49 49 49 49 49 50 0 0 0 0 0 0 64 0 0 0 0 0 0 0 0 0 0 0 0 74 79 79 79 79 79 75 0 0 0 0 0 0 72 78 65 68 71 0 0 0 0 0 0 0 0 0 0 0 0 0 0 63 0 0 72 78 78 78 78 
73 0 0 0 0 0 0 0 0 0 0 0 0 0 0 63 63 0 0 0 0 0 0 70 71 0 0 0 0 72 78 78 78 78 78 73 0 0 57 57 61 0 0 37 0 0 0 0 25 26 27 0 0 0 0 0 0 0 0 0 0 0 0 64 0 0 0 0 0 0 0 0 0 0 72 78 78 78 78 0 0 0 0 28 29 30 0 0 0 0 0 22 23 23 23 23 23 46 23 23 24 0 0 0 47 47 51 47 47 47 47 0 16 0 0 0 0 0 0 0 0 0 0 0 0 0 0 0 0 0 0 0 0 0 0 0 0 0 63 0 0 0 0 72 65 78 78 78 71 0 0 0 0 0 0 0 10 11 12 0 0 0 0 0 0 72 78 65 65 78 
73 0 0 0 0 0 0 0 0 0 0 0 0 0 0 0 0 0 0 0 0 0 0 74 75 0 0 0 0 72 78 78 78 65 78 73 0 0 61 57 57 0 0 38 0 0 17 0 0 0 0 0 0 0 0 0 0 0 0 17 0 0 0 0 0 0 0 0 0 0 0 0 0 0 72 78 78 65 78 0 0 0 0 0 0 0 0 17 0 0 0 22 46 23 23 23 23 46 23 23 24 0 0 0 51 47 47 47 47 51 47 49 49 50 0 18 17 0 0 0 31 0 0 0 0 0 0 0 0 0 0 0 0 0 10 11 12 0 0 0 0 0 0 72 78 78 78 78 73 0 0 0 0 0 0 0 13 14 15 0 0 0 0 0 0 72 78 78 78 78 
73 0 0 0 10 11 12 0 0 0 0 0 0 0 0 0 0 0 0 0 18 17 0 0 0 0 0 0 0 72 65 78 78 78 78 73 0 0 57 61 57 0 0 70 65 65 71 0 0 0 0 28 29 30 0 0 0 0 0 70 65 71 7 7 7 7 7 7 7 7 7 7 7 7 72 78 78 78 78 0 0 0 0 0 0 0 52 53 53 54 0 22 23 23 23 23 23 46 46 46 24 0 0 0 47 47 47 51 47 47 51 47 47 47 49 49 49 50 0 0 32 0 0 0 0 0 0 16 0 0 0 0 17 0 13 14 15 0 17 0 16 0 0 72 78 78 78 78 73 0 0 0 0 0 0 52 53 53 53 54 0 0 0 0 0 72 78 78 78 78 
68 65 65 65 65 65 65 65 65 65 65 65 65 65 65 65 65 65 65 65 65 71 7 7 7 7 7 7 7 72 78 78 78 78 78 73 7 7 57 57 61 7 7 72 65 78 73 0 0 0 0 0 0 0 0 17 0 0 70 69 78 73 5 5 5 5 5 5 5 5 5 5 5 5 72 65 78 78 78 7 7 7 7 7 7 7 56 56 55 56 7 22 23 46 23 23 23 23 23 23 24 7 7 7 47 51 47 47 47 47 47 47 47 47 51 47 47 47 1 1 40 41 42 0 0 0 48 50 0 0 70 65 65 65 65 65 65 65 65 65 65 65 65 69 78 65 78 78 73 7 7 7 7 7 7 55 56 56 56 56 7 7 7 7 7 72 65 65 78 78 
78 78 78 78 65 78 78 78 78 78 78 65 78 65 78 78 78 65 78 78 78 73 5 5 5 5 5 5 5 72 78 78 78 65 78 73 5 5 61 57 57 5 5 72 78 78 73 7 7 7 7 7 7 7 70 65 65 65 69 65 78 73 5 5 5 5 5 5 5 5 5 5 5 5 72 78 78 78 78 5 5 5 5 5 5 5 55 56 56 56 5 22 23 23 23 23 23 23 23 23 24 5 5 5 47 47 47 51 47 47 47 47 51 47 47 47 47 51 2 2 44 39 43 1 1 1 47 47 1 1 72 78 78 78 78 65 78 78 78 78 78 78 78 78 78 78 78 78 73 5 5 5 5 5 5 56 56 55 56 55 5 5 5 5 5 72 78 78 78 78 
